<PAD>	<PAD>
_	_
chang1	昌 娼 猖 伥 阊 菖 鲳
mang2	忙 茫 盲 芒 氓 邙 硭
feng1	风 封 丰 峰 疯 锋 蜂 枫 烽 酆 葑 沣 砜 讽 鋒
ha1	哈 铪
zha3	眨 砟
xi2	席 习 袭 媳 檄 隰 觋 锡 熄
ping2	坪 苹 萍 平 凭 瓶 评 屏 缾
xin5	忄
xia1	瞎 虾 呷
duan3	短
wo3	我
huo5	活 火 伙 和
ning2	柠 狞 凝 宁 拧 咛 甯
tong5	同 筒
rang5	嚷
qiang4	呛 跄 炝 戗
dao1	刀 叨 忉 氘
huan1	欢 獾 驩
diao4	调 掉 吊 钓 铫 铞 調
tong3	统 筒 桶 捅 侗
ba2	八 拔 跋 茇 菝 魃
tun4	褪
guai4	怪
er4	二 贰 佴 弐
kui1	亏 窥 盔 岿 悝
yo1	育 哟 唷
xie2	叶 协 鞋 携 斜 胁 谐 邪 挟 偕 撷 勰 颉 缬 写
xing2	行 形 型 刑 邢 陉 荥 饧 硎
du1	都 督 嘟 阇
a3	啊 呵
bai2	白 百 拜
shou1	收 収
xian1	先 鲜 仙 掀 纤 暹 莶 锨 氙 祆 籼 酰 跹 掺
guai1	乖 掴
long1	隆
qi2	其 旗 琪 骑 骐 棋 歧 岐 琦 齐 奇 祁 祺 麒 起 祈 淇 芪 锜 脐 綦 鳍 圻 耆 畦 崎 俟 祇 蕲 埼 鬐
zhong3	种 肿 踵 冢
zhua3	爪
jue2	觉 绝 决 角 脚 嚼 掘 诀 崛 爵 抉 倔 獗 厥 蹶 攫 谲 矍 孓 橛 噱 珏 桷 劂 爝 镢 蕨 觖 瑴 泬 玦 駃
ju1	车 据 且 居 俱 拘 驹 鞠 锯 趄 掬 疽 裾 苴 椐 锔 狙 琚 雎 鞫 蜛 沮 娵
lao1	捞
gui2	鬼
fen2	坟 焚 汾 棼 鼢 蚡
xia2	峡 侠 狭 霞 暇 辖 遐 匣 黠 瑕 狎 硖 瘕 柙
qu1	区 曲 屈 趋 驱 躯 觑 岖 蛐 祛 蛆 麴 诎 黢 麹 駆 佉
zai3	载 仔 宰 崽
fu1	夫 肤 敷 孵 呋 稃 麸 趺 跗 芙 鄜
han4	汉 汗 憾 翰 撼 旱 捍 悍 瀚 焊 颔 菡 撖
ji4	记 系 计 济 寄 际 技 纪 继 既 齐 季 寂 祭 忌 剂 冀 妓 骥 蓟 悸 伎 暨 霁 稷 偈 鲫 髻 觊 荠 跽 哜 鲚 洎 芰 迹 绩 骑 垍 継 済 惎
qu5	戌 曲 去 趣
sha3	傻
po3	颇 叵
wa5	哇 娃
nai2	奶
nei4	内 內 那
qian1	千 签 牵 迁 谦 铅 骞 悭 芊 愆 阡 仟 岍 扦 佥 搴 褰 钎
nong2	浓 农 侬 脓 醲 哝
ge3	个 各 合 盖 葛 哿 舸
yu2	于 与 余 予 鱼 愚 舆 娱 愉 馀 逾 渔 渝 俞 萸 瑜 隅 揄 榆 虞 禺 谀 腴 竽 妤 臾 欤 觎 盂 窬 蝓 嵛 狳 舁 雩 於 雨 嵎 邘 伃
yao2	摇 遥 姚 陶 尧 谣 瑶 窑 肴 侥 铫 珧 轺 爻 徭 繇 鳐 垚 揺
kan5	看
duan4	断 段 锻 缎 煅 椴 簖
fa4	发 珐 髪
ang2	昂 卬
sou4	嗽 擞
jue1	嗟 撅 噘
ju4	据 句 具 剧 巨 聚 拒 距 俱 惧 沮 瞿 锯 炬 趄 飓 踞 遽 倨 钜 犋 屦 榘 窭 讵 醵 苣
men4	闷 懑 焖
weng1	翁 嗡 鶲
nao2	挠 铙 猱
zhu3	主 属 煮 嘱 瞩 拄 褚 渚 麈 丶
guo3	果 裹 猓 椁 蜾 叵 粿
tie1	贴 帖 萜
sui1	虽 尿 荽 睢 眭 濉
lei3	累 蕾 垒 磊 儡 诔 耒
chao4	耖
nian4	念 廿
luan4	乱
chun3	蠢
zhu4	住 注 助 著 驻 祝 筑 柱 铸 伫 贮 箸 炷 蛀 杼 翥 苎 疰 鋳 壴 砫 纻 竚
cun4	寸 吋
sui2	随 遂 隋 绥
dui1	堆
gai1	该 赅 垓 陔
cun1	村 皴 邨
lu4	六 路 陆 录 露 绿 鹿 碌 禄 辘 麓 赂 漉 戮 簏 鹭 潞 璐 辂 渌 蓼 逯 録 箓
sai5	噻
tian2	田 填 甜 恬 佃 阗 畋 钿 嗔 湉 塡 畑 鷏
de2	得 德 锝 嘚 徳
ku4	库 裤 酷 喾 绔
tou3	钭
n2	嗯
cheng2	成 城 程 承 诚 盛 乘 呈 惩 澄 橙 丞 埕 枨 塍 铖 裎 酲 晟 郕 乗
kun3	捆 悃 阃 壸
mian5	面
nian1	蔫 拈
zhuang1	装 庄 妆 桩
an3	俺 铵 揞 埯
bian4	便 变 遍 辩 辨 辫 卞 苄 汴 忭 弁 缏
nie1	捏 㖏
chong4	冲 铳
sai1	思 塞 腮 鳃 噻
qiao3	悄 巧 雀 愀
xun4	训 迅 讯 逊 熏 殉 巽 徇 汛 蕈 浚 驯
mi3	米 眯 靡 弭 敉 脒 芈 洣 迷
que2	瘸
can3	惨 黪
gen3	艮
huang2	黄 皇 煌 惶 徨 璜 簧 凰 潢 蝗 蟥 遑 隍 磺 癀 湟 篁 鳇 黃 騜
pai1	拍
lue4	略 掠 锊
tan5	弹
kong2	孔
cha1	差 插 叉 碴 喳 嚓 杈 馇 锸 茶
dang3	党 挡 谠 档 件
yang1	央 泱 秧 鸯 殃 鞅
o1	噢 喔
fen3	粉
zhi5	置 质 制 指 脂
jin1	今 金 禁 津 斤 筋 巾 襟 矜 衿
nai4	耐 奈 褦 萘 鼐 柰
yong4	用 佣
pei4	配 佩 沛 辔 霈 珮
niu4	拗
hu5	乎 糊 唬
wei3	委 伟 唯 尾 玮 伪 炜 纬 萎 娓 苇 猥 痿 韪 洧 隗 诿 艉 鲔 亹 梶 薳 頠
shua3	耍
pa5	琶 杷
fu4	服 复 父 负 副 富 付 妇 附 赴 腹 覆 赋 傅 缚 咐 阜 讣 驸 赙 馥 蝮 鲋 鳆 負 阝 冨 袝 褔
er2	而 儿 鸸 鲕 洱 耳 兒 輀
pan1	攀 潘 番
zou4	奏 揍 骤
geng3	耿 颈 梗 哽 鲠 埂 绠
ga4	尬
ao3	袄 拗 媪
yang5	鸯 扬 阳
lou4	露 陋 漏 镂 瘘
zou2	走
jun3	菌
pan2	盘 胖 磐 片 碟 槃 蟠 爿 盤 鞶 磻
dian4	电 店 甸 淀 垫 殿 奠 惦 佃 玷 簟 坫 靛 钿 癜 阽
ma4	骂 蚂 唛 杩 犸
mai4	卖 麦 迈 脉 劢 売
guang2	广
su2	俗
sheng5	生 声
pian5	片
luo3	裸 倮 蠃 瘰
na1	南
han1	酣 憨 顸 鼾 蚶
wei1	威 微 危 巍 萎 偎 薇 逶 煨 崴 葳 隈 委
you4	有 又 右 幼 诱 佑 柚 囿 鼬 宥 侑 蚴 釉 祐
lian4	练 恋 炼 链 殓 楝 潋 鍊 僆
gei3	给 給
xuan3	选 癣 烜
ding4	定 订 钉 铤 腚 锭 碇 啶
lin1	拎
shi5	殖 匙 十 识 是 食 释 实 势
ge5	个 歌
nang5	囊
nv4	衄
peng5	篷 蓬
tan1	摊 贪 滩 瘫 坍
ai3	矮 哎 蔼 霭 嗳 毐
zang1	赃 臧 锗 脏 牂
bi1	逼 偪
cuo3	撮 脞
tun1	吞 暾
lang5	朗
cui4	脆 粹 萃 翠 瘁 悴 淬 毳 啐
nve4	疟 虐
hua1	华 化 花 哗 砉
quan4	劝 券 勧
du3	肚 睹 堵 赌 笃 覩
lou3	搂 篓 嵝
ha2	虾 蛤
fan4	饭 犯 范 贩 泛 梵 畈 飯 氾
xu5	蓿
gai2	改
tong2	同 童 彤 铜 桐 瞳 佟 酮 侗 仝 垌 茼 峒 潼 砼 硐 僮 鲖 烔
hang2	行 航 吭 杭 绗 珩 颃
luan3	卵
ao4	奥 澳 傲 懊 坳 拗 骜 岙 鏊
kuang3	夼
yun3	允 陨 殒 狁
chai1	差 拆 钗
sang5	丧
duo5	朵
lve4	略 掠
geng1	更 耕 庚 羹 赓 畊
ni4	匿 腻 逆 溺 昵 泥
lun2	论 轮 伦 沦 仑 抡 囵 纶
ga2	嘎 噶 轧 尜 钆
re4	热
xuan2	旋 悬 玄 漩 璇 痃 选 玹
cheng3	逞 骋 裎
nao1	孬
tao3	讨
bei2	北
xiang4	相 向 象 像 项 巷 橡 蟓
bai3	百 摆 伯 柏 佰 捭
long2	龙 隆 笼 胧 咙 聋 珑 窿 茏 栊 泷 砻 癃 眬
miao1	喵
ken4	裉
jue3	蹶
deng4	邓 凳 瞪 澄 蹬 磴 镫 嶝
qi3	起 讫 启 企 岂 祈 乞 绮 杞 芑 稽 屺 玘 棨
lu3	鲁 芦 卤 虏 掳 橹 镥 撸
xiong5	兄
zhao4	照 赵 召 罩 兆 肇 诏 棹 笊
guan4	观 惯 冠 贯 罐 灌 掼 盥 涫 鹳
zuan1	钻 躜
hang1	夯
za2	杂 咱 砸
lang3	朗
zhuo1	桌 捉 卓 拙 涿 焯 倬
bo4	薄 柏 簸 掰 擘 檗
wo5	窝
mei2	没 眉 梅 媒 枚 煤 霉 玫 糜 酶 莓 嵋 湄 楣 猸 镅 鹛 美 每 沒
la5	蓝 啦 拉
you1	优 幽 忧 悠 攸 呦
shai3	色
shen3	审 沈 婶 谂 哂 渖 矧 瞫
hun4	混 诨 溷
tuan3	疃
xiang2	降 详 祥 翔 庠 想
dei3	得
la1	拉 啦 喇 垃 邋
meng2	蒙 盟 朦 氓 萌 檬 瞢 甍 礞 虻 艨 濛
kui3	傀 跬
ying3	影 颖 颍 瘿 郢
xiu1	修 休 羞 咻 馐 庥 鸺 貅 髹 貅 脩
yun1	晕 氲 赟 奫
ao1	熬 凹
pai2	排 牌 徘 俳
zai4	在 再 载 縡
yin2	银 吟 寅 淫 垠 鄞 霪 狺 夤 圻 龈 饮 引 隐 銀 訚
gua1	括 瓜 刮 呱 栝 胍 鸹 蜗
wa4	瓦 袜 腽
bie1	憋 瘪 鳖
zhui1	追 锥 隹 椎 骓
li3	里 理 李 礼 哩 鲤 俚 逦 娌 悝 澧 锂 蠡 醴 鳢 裡 豊
kuai4	会 快 块 筷 脍 哙 侩 狯 浍 郐 桧 速
reng1	扔
feng4	奉 缝 凤 俸 葑 鳳 鳯
re3	若 惹 喏
tou2	头 投 骰
guan2	管 馆
zan2	咱
cai3	采 彩 踩 睬
mo3	抹
rong1	茸
yuan1	冤 渊 鸳 眢 鸢 箢
he4	和 何 喝 赫 吓 贺 荷 鹤 壑 褐
lang1	啷
lu5	轳 氇 噜 芦
chong2	重 崇 虫 茧
piao1	飘 漂 缥 剽
cha3	叉 衩 镲
zhen2	诊
bu3	补 捕 堡 卜 哺 卟
sai4	赛 塞
en4	摁 嗯
sen1	森
ka1	咖 喀 咔
fu5	咐 服 袱 夫 腐 复 父
wang4	望 王 往 忘 旺 妄 枉
liu1	溜 熘
yi3	以 已 衣 尾 椅 矣 乙 蚁 倚 迤 蛾 旖 苡 钇 舣 酏 欺 顗 齮
hui3	毁 悔 虺
pa1	啪 趴 爬 葩
cun3	忖
chou4	臭
niu2	牛
zao1	遭 糟
shui2	谁 水
le5	了 饹
gao1	高 糕 膏 皋 羔 睾 篙 槔
zhen3	诊 枕 疹 缜 畛 轸 稹
na4	呐 钠 那 娜 纳 衲 么 捺
dang2	党
lu2	卢 炉 庐 芦 颅 泸 轳 鲈 垆 胪 鸬 舻 栌 髗
zheng3	整 拯
jiu3	九 酒 久 韭 灸 玖 赳
pie2	撇
ni3	拟 你 旎
leng1	棱
jian4	见 间 件 建 监 渐 健 剑 键 荐 鉴 践 舰 箭 贱 溅 槛 谏 僭 涧 饯 毽 锏 楗 腱 牮 踺 見 剣
zha4	炸 咋 诈 乍 蜡 栅 榨 柞 吒 咤 痄 蚱
he5	合 喝 荷
zan3	攒 拶 昝 趱
cen2	岑 涔
xing5	猩
shui4	说 税 睡 蜕
wa1	挖 哇 凹 娲 蛙 洼
ai2	呆 挨 癌 皑 捱 矮
ti4	替 涕 剃 惕 屉 嚏 悌 倜 逖 绨 裼 薙
zhang3	长 掌 涨 仉 長
jiu4	就 旧 救 疚 舅 咎 臼 鹫 僦 厩 桕 柩 鷲
xun1	熏 勋 荤 醺 薰 埙 曛 窨 獯 纁
zhan1	占 沾 粘 瞻 詹 毡 谵 旃 鳣 鹯 邅
heng5	哼
jian1	间 坚 监 渐 兼 艰 肩 浅 尖 奸 溅 煎 歼 缄 笺 菅 蒹 搛 湔 缣 戋 犍 鹣 鲣 鞯 瑊
ni1	妮 妞
qu3	取 曲 娶 龋 苣
niu3	扭 钮 纽
qi5	气 起
qiang2	强 墙 蔷 樯 嫱
pang1	乓 雱
zi4	自 字 渍 恣 眦
pin4	聘 牝
la2	拉 喇 旯 砬 邋 剌
ming2	名 明 鸣 盟 铭 冥 茗 溟 瞑 暝 螟 洺
chang4	唱 畅 倡 怅 鬯 玚
qian2	前 钱 潜 乾 虔 钳 掮 黔 荨 钤 犍 箝 鬈
wan1	湾 弯 蜿 剜 豌 灣
nao5	闹
zen4	谮
pin2	频 贫 品 嫔 颦
da1	答 搭 嗒 耷 褡 哒 瘩 荅
luan2	峦 挛 孪 栾 銮 滦 鸾 娈 脔
yang2	洋 阳 杨 扬 羊 疡 佯 烊 徉 炀 蛘 养 仰 陽 珜
chu3	处 楚 储 础 杵 褚 楮
jia4	价 假 架 驾 嫁 稼
chou3	丑 瞅
se4	色 塞 涩 瑟 啬 铯 穑 沙
rao2	饶 娆 桡 荛
pou3	婄
gu3	古 股 鼓 骨 谷 贾 汩 蛊 毂 鹄 牯 臌 诂 瞽 罟 钴 嘏 蛄 鹘 榖 穀
wang5	望 枉 王
si2	死
kun4	困
ren5	人
miao2	描 苗 瞄 鹋
xue3	雪 鳕
kou3	口
zhao2	着 著
ju2	局 菊 桔 橘 锔 举 跼 鵴 焗
bing1	并 兵 冰 槟 冫
an4	案 按 暗 岸 黯 胺 犴 闇 晻
ji3	几 给 己 革 济 纪 挤 脊 戟 虮 掎 麂 已 嵴
mi1	眯 咪
lia2	俩
mo2	无 模 麽 磨 摸 摩 魔 膜 蘑 馍 摹 谟 謩
bu4	不 部 布 步 怖 簿 埔 埠 瓿 钚 唔 歩
zuan4	赚 钻 攥
kou1	抠 芤 眍 q
zun3	撙
ａ5	ａ
po1	坡 泼 颇 泊
ke2	咳 壳 颏 可
cuo2	嵯 矬 痤 瘥 鹾
jing1	经 京 精 惊 睛 晶 荆 兢 鲸 泾 旌 茎 腈 菁 粳 鼱 経 筋
ci4	次 刺 赐 伺 剌 蚝
kan4	看 嵌 瞰 阚 磡
jiao4	教 觉 校 叫 较 轿 嚼 窖 酵 噍 峤 徼 醮
zhuang4	状 壮 撞 幢 僮 戆 壵
zhan2	展
man4	慢 漫 曼 蔓 谩 墁 幔 缦 熳 镘
qin5	亲
gan4	干 赣 淦 绀 旰 乾 幹
cuo1	搓 撮 磋 蹉
sun3	损 笋 榫 隼
ceng2	曾 层 竲
mang3	莽 蟒 漭
zhang4	丈 涨 帐 障 账 胀 仗 杖 瘴 嶂 幛
ji5	记 计 疾 积 箕 辑
ci3	此 泚
guang1	光 咣 胱 桄 洸
ga1	咖 嘎 胳 伽 旮 呷
wai1	歪
mou3	某
tie2	铁
bao3	保 宝 饱 堡 葆 褓 鸨
wen2	文 闻 纹 蚊 雯 璺 阌 稳 炆 玟
xi1	西 息 希 吸 惜 稀 悉 析 夕 牺 腊 昔 熙 兮 溪 嘻 锡 晰 樨 熄 膝 栖 郗 犀 曦 奚 羲 唏 蹊 淅 皙 汐 嬉 茜 熹 烯 翕 蟋 歙 浠 僖 穸 蜥 螅 菥 舾 矽 粞 硒 醯 欷 鼷 雪 典 豨 貕 晞 憙 悕 肸 鸂 晳
teng2	腾 疼 藤 誊 滕
yue5	月
qun2	群 裙 麇 羣
lan3	懒 览 揽 榄 缆 漤 罱 懶
kua1	夸 侉
zui3	嘴 咀 觜
xue1	削 靴 薛
jiu2	九
lan4	烂 滥 缆
kan3	侃 砍 坎 槛 阚 莰
shou3	手 首 守 艏
biao4	鳔
kao3	考 烤 拷 栲
nuan2	暖
li5	璃 哩 莉 里 娌
chu2	除 厨 躇 橱 雏 锄 蜍 刍 滁 蹰 处 储 鉏 蓄
wang3	往 网 枉 惘 罔 辋 魍
lo5	咯
zhen1	真 针 珍 斟 贞 侦 甄 臻 箴 砧 桢 溱 蓁 椹 榛 胗 祯 浈 禛
nen4	嫩
shu4	数 术 树 述 束 竖 恕 墅 漱 俞 戍 庶 澍 沭 腧 曙
fei4	费 废 沸 肺 吠 痱 狒 镄 芾 砩
xian4	现 见 线 限 县 献 宪 陷 羡 馅 腺 岘 苋 霰 現 蚬 県
yan3	眼 演 掩 衍 奄 俨 偃 魇 鼹 兖 郾 琰 罨 厣 剡 鼽 弇 沇 黡 縯
fa1	发 発
nuo4	懦 糯 诺 喏
suan4	算 蒜 筭
rong3	冗
hao3	好 郝
shou4	受 授 售 瘦 寿 兽 狩 绶 獣
seng1	僧
nan2	南 男 难 楠 喃 柟
hu2	和 胡 湖 糊 核 壶 狐 葫 弧 蝴 囫 瑚 斛 鹄 醐 猢 槲 鹕 觳 煳 鹘 縠
zi5	子
chuang3	闯
long4	弄
ding1	丁 盯 钉 叮 町 酊 疔 仃 耵 玎
mai3	买 荬 買
shao2	勺 韶 苕 杓 芍
liu4	六 陆 溜 碌 遛 馏 镏 鹨
ka2	卡
bai1	掰
wei2	为 维 围 唯 违 韦 惟 帷 帏 圩 囗 潍 桅 嵬 闱 沩 涠 位 薇
tiao4	跳 眺 粜
chui5	吹
qie2	茄 伽
chao5	吵
jin3	尽 仅 紧 谨 锦 瑾 馑 卺 廑 堇 槿 緊
ren3	忍 稔 荏
ru2	如 儒 茹 嚅 濡 孺 蠕 薷 铷 襦 颥 乳
xi5	息 系
kuai3	蒯
hai1	嘿 咳 嗨
ning4	拧 泞 宁 佞
bin4	鬓 殡 摈 膑 髌
jin4	进 近 尽 仅 禁 劲 晋 浸 靳 缙 烬 噤 觐 荩 赆 妗 琎 溍 搢
she3	舍
beng4	绷 蹦 迸 甏 泵 蚌
shua1	刷 唰
gan5	杆
fang4	放 播
tuo3	妥 椭 庹
gun3	滚 鲧 衮 绲 磙 辊 混
tai1	台 胎 苔
rong2	容 荣 融 蓉 溶 绒 熔 榕 戎 嵘 茸 狨 肜 蝾 镕 栄
pin1	拼 拚
ti2	提 题 啼 蹄 醍 绨 缇 鹈 荑 騠
yong3	永 勇 涌 踊 泳 咏 俑 恿 甬 蛹 臃
dan4	但 担 石 弹 淡 旦 蛋 诞 惮 啖 澹 氮 萏 瘅 吐 禫
jin5	进
e4	恶 饿 扼 愕 遏 噩 呃 厄 鄂 轭 颚 鳄 谔 锷 萼 腭 垩 鹗 苊 阏 惡
ke1	科 颗 柯 呵 棵 苛 磕 坷 嗑 瞌 轲 稞 疴 蝌 钶 窠 颏 珂 髁 榼 匼 牁
nai3	氖 乃 奶 妳 廼
lai5	来
ying5	蝇 盈
rang1	嚷
su1	苏 稣 酥 窣 蘇
chang2	长 场 常 尝 肠 偿 倘 裳 嫦 徜 苌 厂
ben3	本 苯 畚
zhong2	种
zong1	宗 踪 综 棕 鬃 枞 腙 倧
nu2	奴 孥 驽
liao4	了 料 廖 镣 撩 撂 尥 钌 瞭
yao4	要 药 耀 钥 鹞 曜 疟 矅
heng4	横
la4	落 拉 辣 腊 蜡 剌 瘌
die1	爹 跌 踮 嗲
yi4	意 义 议 易 衣 艺 译 异 益 亦 亿 忆 谊 抑 翼 役 艾 溢 毅 裔 逸 轶 弈 翌 疫 绎 佚 奕 熠 诣 弋 驿 懿 呓 屹 薏 噫 镒 缢 邑 臆 刈 羿 仡 峄 怿 悒 肄 佾 殪 挹 埸 劓 镱 瘗 癔 翊 蜴 嗌 翳 一 腋 鞥 裛 浥 乂 宜 泆 潩 豷
bang3	膀 榜 绑
weng5	嗡
lei1	勒 擂
quan1	圈 悛
tu4	吐 兔 堍 菟
you2	由 游 油 邮 尤 犹 柚 鱿 莸 尢 铀 猷 疣 蚰 蝣 蝤 繇 莜 有 友 櫾 楢
lao2	劳 牢 唠 崂 铹 痨 醪 老
luo2	罗 逻 萝 螺 锣 箩 骡 猡 椤 脶 镙
zi3	子 紫 仔 梓 姊 籽 滓 秭 笫 耔 茈 訾
mie1	乜 咩
ka3	卡 咯 咔 佧 胩
lu1	噜 撸
zhu1	诸 朱 珠 猪 株 蛛 洙 诛 铢 茱 邾 潴 槠 橥 侏
rao4	绕
lang4	浪 郎 莨 蒗 阆 崀
zu3	组 祖 阻 诅 俎 元
di2	敌 笛 的 迪 涤 嘀 狄 嫡 翟 荻 籴 觌 镝
du4	度 渡 肚 杜 妒 镀 芏 蠹
pu4	铺 曝 瀑 暴 堡
yang4	样 漾 恙 烊 怏 鞅 杨 様
zao3	早 澡 枣 蚤 藻 缲
shuai1	衰 摔
hai2	还 孩 骸 海 還 寰 鬟 桓
ba5	吧 罢 巴 叭 粑
xu3	许 浒 栩 诩 糈 醑 許 冔
hun1	婚 昏 荤 阍
lian2	联 连 怜 莲 廉 帘 涟 镰 裢 濂 臁 奁 蠊 鲢
qiu2	求 球 仇 囚 酋 裘 虬 俅 遒 赇 泅 逑 犰 蝤 巯 鼽
duan1	端
cha2	查 察 茶 叉 茬 碴 楂 猹 搽 槎 檫 詧 嵖
niang4	酿
gui3	鬼 轨 诡 癸 匦 庋 宄 晷 簋
xiong2	雄 熊
chao1	超 抄 吵 钞 绰 剿 焯 怊
er3	尔 耳 迩 饵 洱 珥 铒 林 尓
yan2	言 严 研 延 沿 颜 炎 阎 盐 岩 铅 蜒 檐 妍 筵 芫 闫 阽 眼 嵒 讠 塩
mo5	寞 沫 磨 麿
shou2	熟 手 首
ei3	诶
a5	阿 啊 呵
feng3	讽 唪
bo3	簸 跛
jiang3	讲 奖 蒋 桨 耩 蔣
gao3	稿 搞 藁 槁 缟 镐 杲
piao3	瞟 漂 醥
suan1	酸 狻
ji2	及 即 辑 级 极 集 急 籍 吉 疾 嫉 藉 脊 棘 汲 岌 笈 瘠 诘 亟 楫 蒺 殛 佶 戢 嵴 蕺 给 几 击 圾 伋
ma3	马 吗 码 玛 蚂 犸
nu4	怒
lin4	淋 吝 躏 赁 蔺 膦
wa2	娃 瓦
bia3	柏
zhi4	知 至 制 识 治 志 致 质 智 置 秩 滞 帜 稚 挚 掷 峙 窒 炙 痔 栉 桎 帙 轾 贽 痣 豸 陟 忮 彘 膣 雉 鸷 骘 蛭 踬 郅 觯 寘 跱 铚 厔 晊
ou2	偶
shi4	是 事 世 市 士 式 视 似 示 室 势 试 释 适 氏 饰 逝 誓 嗜 侍 峙 仕 恃 柿 轼 拭 噬 弑 谥 莳 贳 铈 螫 舐 筮 识 視 適 奭 礻 栻 知 媞
ce4	策 测 侧 厕 册 恻
run4	润 闰
jun4	俊 峻 隽 菌 郡 骏 竣 捃 浚 濬 畯 珺 埈 晙
ming4	命
pou2	锫
chuang1	创 窗 疮
juan1	捐 圈 娟 鹃 涓 镌 蠲
gou4	够 购 构 勾 觏 垢 诟 媾 遘 彀
jiao1	教 交 焦 骄 郊 胶 椒 娇 浇 姣 跤 蕉 礁 鲛 僬 鹪 蛟 艽 茭 憍
jian2	减 柬
mei5	妹
ge1	歌 格 哥 戈 割 胳 搁 疙 咯 鸽 屹 仡 圪 纥 袼 鴐
han3	喊 罕 阚
che4	彻 撤 澈 掣 坼 辙
tiao3	挑 窕 脁
jing5	睛
lei5	嘞
wo2	哦 我
luo1	落 罗 捋 啰
tao2	逃 陶 桃 淘 萄 啕 洮 鼗
bo2	博 伯 勃 薄 泊 柏 驳 魄 脖 搏 膊 舶 礴 帛 铂 箔 渤 钹 孛 亳 鹁 踣 饽 玻 鎛
ta4	踏 拓 榻 嗒 蹋 沓 挞 闼 漯 遢
mai2	埋 霾
bei5	臂 呗 备
jiang2	讲 奖
po5	婆
yin1	因 音 烟 阴 姻 殷 茵 荫 喑 湮 氤 堙 洇 铟 愔 蒑 吟
ben1	奔 贲 锛
qiu3	糗
shuo4	数 朔 硕 烁 铄 妁 蒴 槊 搠 箾
meng1	蒙
liang4	量 亮 辆 凉 谅 晾 踉 靓
tuo2	陀 舵 驼 砣 驮 沱 跎 坨 鸵 橐 佗 铊 酡 柁 鼍 托
xu1	需 须 虚 吁 嘘 墟 戌 胥 砉 圩 盱 顼 虛 訏 歔 旴
chong1	冲 充 涌 憧 忡 艟 舂 茺 衝
ou4	沤
cai4	采 菜 蔡
feng2	逢 缝 冯
shuan4	涮
lin3	凛 懔 檩 廪
chen2	陈 沉 晨 沈 尘 臣 辰 橙 忱 谌 宸 陳
chen5	伧
tiao1	挑 佻 祧
zhen4	阵 镇 震 圳 振 赈 朕 鸩 瑱
ye5	爷
nei3	馁 哪
nuan3	暖
a2	啊 呵 嗄
ling2	令 灵 零 龄 凌 玲 铃 陵 伶 聆 囹 棱 菱 苓 翎 棂 瓴 绫 酃 泠 羚 蛉 柃 鲮 领 岭 澪 鸰 夌 琌 霊
bao4	报 暴 抱 爆 鲍 曝 刨 瀑 豹 趵
long3	笼 拢 垄 陇 垅
ｔ5	ｔ
ge4	个 各 铬 硌 虼 個
zi1	资 咨 滋 仔 姿 吱 兹 孜 谘 呲 龇 锱 辎 淄 髭 赀 孳 粢 趑 觜 訾 缁 鲻 嵫 鹚
he2	和 何 合 河 核 盒 禾 荷 阂 涸 阖 貉 曷 颌 劾 菏 盍 纥 蚵 翮 褐 蝎 省 鞨 郃 龢
lou2	楼 喽 偻 娄 髅 蝼 蒌 耧
zhe1	折 遮 蜇
lai2	来 莱 徕 涞 崃 铼 來
hao4	好 号 浩 耗 皓 昊 灏 镐 颢
yue4	月 越 阅 跃 乐 悦 岳 粤 说 钥 刖 瀹 栎 樾 龠 钺 玥
kang2	扛
zui1	堆
can2	残 惭 蚕
a4	啊 呵
gei2	给
zhou1	周 州 洲 粥 舟 诌 啁 盩
shen2	什 神 甚 希
fa5	发
sa4	萨 卅 飒 脎 撒 沙
beng2	甭
ying4	应 硬 映 媵
chuan3	喘 舛
pa2	爬 琶 杷 扒
rui4	瑞 锐 芮 睿 枘 蚋 里
cha4	差 刹 叉 诧 岔 衩 杈 汊 姹
ca3	礤
sheng2	绳 渑
lv4	律 绿 率 虑 滤 氯 緑 嵂
shun5	顺
xiao1	消 销 潇 肖 萧 宵 削 嚣 逍 硝 霄 哮 枭 骁 箫 枵 哓 蛸 绡 魈 銷 蠨 清 鸮 虓 猇
wan4	万 腕 蔓 萬 妧
cong2	从 丛 琮 淙
ma5	么 吗 嘛 妈 嗎
juan3	卷 锩
cang2	藏
pu2	仆 莆 葡 菩 蒲 谱 濮 璞 脯 匍 酺
chang5	场
che3	扯
shuan1	栓 拴 闩
de5	的 地 得 弟
ai4	爱 碍 艾 唉 哎 隘 暧 嗳 瑷 嗌 嫒 砹 愛 叆
xu4	续 序 绪 蓄 叙 畜 恤 絮 旭 婿 酗 煦 洫 溆 勖 垿 壻 慉
san3	散 伞 馓 糁 霰
yao3	咬 杳 窈 舀 崾 騕
rou5	柔
zhu5	住
shan3	闪 陕 掺 掸
ying1	应 英 鹰 婴 樱 膺 莺 罂 鹦 缨 瑛 璎 撄 嘤 媖 锳 罃 蘡 蠳
pao3	跑
zuo3	左 佐 撮
bei1	背 悲 杯 碑 卑 陂 埤 萆 鹎
xue4	血 谑
xia4	下 夏 吓 厦 唬 罅
gao4	告 膏 诰 郜 锆 吿
niang2	娘
tao1	涛 掏 滔 叨 焘 韬 饕 绦
zuo4	作 做 坐 座 怍 胙 阼 唑 祚
long5	咙
wu1	於 恶 屋 污 乌 巫 呜 诬 兀 钨 邬 圬
dun4	顿 盾 钝 炖 遁 沌 囤 砘 楯
zao4	造 灶 躁 噪 皂 燥 唣 皁 糟 慥
fan1	翻 番 帆 藩 幡 蕃 籓 噃
chou1	抽 瘳
chun2	纯 唇 醇 淳 鹑 莼
chuan1	穿 川 巛 氚
zhang2	长
ne4	讷 呐
huo4	和 或 获 货 祸 惑 霍 豁 藿 嚯 镬 蠖 濩 矐
ye3	也 野 冶 嘢 埜
nuo2	挪 傩 娜 郍
tie4	帖 餮
chong3	宠
qin2	琴 秦 勤 芹 擒 矜 覃 禽 噙 廑 溱 檎 锓 嗪 芩 螓
song1	松 忪 淞 崧 嵩 凇 菘
dian3	点 典 碘 踮 丶 點
suo3	所 索 锁 琐 唢
le4	乐 勒 仂 叻 泐 鳓 捋 楽
chu1	出 初 樗
tui5	退
cang1	苍 仓 沧 舱 伧
zhui4	坠 缀 赘 惴 缒
can4	惨 灿 掺 璨 孱 粲
ba4	把 爸 罢 霸 坝 耙 灞 鲅 壩 鲌
hou4	后 候 後 厚 侯 逅 堠 鲎 郈 垕
shuai4	率 帅 蟀
cuan4	窜 篡 爨
yuan4	院 愿 怨 苑 媛 掾 垸 瑗
pen2	盆 湓
duo2	度 夺 踱 铎 掇
ruo4	若 弱 偌 箬
gai3	改
ban3	版 板 阪 坂 钣 舨
chan1	搀 掺 觇
su4	诉 速 素 肃 宿 缩 塑 溯 粟 簌 夙 嗉 谡 僳 愫 涑 蔌 觫 骕 鹔
huang4	晃 皝
zun1	尊 遵 樽 鳟
jia5	家
nao3	脑 恼 瑙 垴
si1	思 斯 司 私 丝 撕 厮 嘶 鸶 咝 澌 缌 锶 蛳 士
wang2	王 亡 芒 往 网
ti1	体 踢 梯 剔 锑
gua3	寡 呱 剐
xu2	徐
zan5	咱
xian2	闲 贤 嫌 咸 弦 娴 衔 涎 舷 鹇 痫 閑 蚿
gui1	规 归 瑰 龟 硅 闺 皈 傀 圭 妫 鲑 珪 邽 槻
zhei4	这
geng4	更
kong1	空 倥 崆 箜
tian4	掭
pin5	频
liao1	撩 撂
dao5	到 叨
xie4	写 解 谢 泄 契 械 屑 卸 懈 泻 亵 蟹 邂 榭 瀣 薤 燮 躞 廨 绁 渫 榍 獬
nang2	囊
chan4	颤 忏 羼
duo1	多 咄 哆 掇 裰 朵
jiao2	嚼 矫 峤 脚
shai4	晒
rang2	瓤 禳 穰 勷 穣
nai5	奶 耐
nou4	耨
tu3	土 吐 钍
shang4	上 尚 绱
sha1	杀 沙 刹 纱 杉 莎 煞 砂 挲 鲨 痧 裟 铩
she1	奢 赊 猞 畲
qin3	寝
sou5	嗽
gun4	棍
fang5	坊
hng5	哼
ye2	爷 耶 邪 揶 铘 也 野 琊 椰
pian2	骈 便
ru4	入 褥 缛 洳 溽 蓐
mao1	猫 貓
xiao3	小 晓 筱
quan2	全 权 泉 拳 诠 颧 蜷 荃 铨 痊 醛 辁 筌 鬈 權 佺 権
kao2	考
guai3	拐
bai5	白
gun2	滚
dou3	斗 抖 陡 蚪
bian5	边
fen1	分 纷 氛 芬 吩 酚 玢 棻
mian4	面
ｋ5	ｋ
bian1	编 边 鞭 砭 煸 蝙 笾 鳊 辺
shan1	山 衫 删 煽 扇 珊 杉 栅 跚 姗 潸 膻 芟 埏 钐 舢 苫 髟 搧
miu4	谬 缪
ri4	日
guo4	过 過 果
ben4	奔 笨 夯 坌 渀
chuan4	串 钏
que1	缺 阙 炔
chou2	愁 仇 筹 酬 绸 踌 惆 畴 稠 帱 俦 雠 讐 雔
zhun1	屯 谆 肫 窀
ceng4	蹭
li1	哩
dun1	吨 敦 蹲 墩 礅 镦 惇 墪
zou3	走
hong4	哄 讧 蕻
cuan2	攒
qiao1	悄 敲 雀 锹 跷 橇 缲 硗 劁 骹
san1	三 叁 毵
chang3	场 厂 敞 氅 昶 惝
bing4	并 病 摒
ye1	耶 噎 椰 掖 晔
chan3	产 铲 阐 谄 冁 蒇 骣
shuang3	爽 塽 樉
niao3	鸟 袅 嬲 茑 褭
tui3	腿
qing2	情 晴 擎 氰 檠 黥 勍
tuan1	湍
chi3	尺 齿 耻 侈 褫 豉 呎 歯
suo2	所 索
ya1	压 雅 呀 押 鸦 哑 鸭 丫 垭 桠 圧
nv3	女 钕
yun2	云 匀 筠 芸 耘 纭 昀 郧 允 沄 伝
ze4	侧 仄 昃
tai2	台 抬 苔 邰 薹 骀 炱 跆 鲐 枱 臺
wo4	握 卧 哦 渥 沃 斡 幄 肟 硪 龌 偓
nan4	难
rao3	扰 绕 娆
chuang4	创 怆
wu2	无 亡 吴 吾 捂 毋 梧 唔 芜 浯 蜈 鼯 五 舞 诬 無 鹀
xue2	学 穴 噱 踅 泶 學
bo5	卜 啵 膊 伯
gong4	共 供 贡
jing3	警 景 井 颈 憬 阱 儆 刭 肼 璟
chao3	炒 吵 的 蛋
bi3	比 笔 彼 鄙 匕 俾 妣 吡 秕 舭
cun2	存 蹲
dian1	颠 滇 掂 癫 巅 甸
tuo1	托 脱 拖 乇 扥 侂
mi2	迷 弥 谜 靡 糜 醚 麋 猕 祢 縻 蘼 米
cui1	衰 催 摧 崔 隹 榱 脆
chao2	朝 潮 嘲 巢 晁 炒
li4	力 利 立 历 例 丽 励 厉 莉 笠 粒 俐 栗 隶 吏 沥 雳 莅 戾 俪 砺 痢 郦 詈 荔 枥 呖 唳 猁 溧 砾 栎 轹 傈 坜 苈 疠 疬 蛎 鬲 篥 粝 跞 暦 涖 歴 瑮
zang4	藏 脏 葬 奘
she4	社 设 舍 涉 射 摄 赦 慑 麝 滠 歙 厍 拾 厙
dao3	导 倒 岛 蹈 捣 祷 嶋
shan2	闪
dong1	东 冬 咚 岽 氡 鸫
jiu1	究 纠 揪 鸠 赳 啾 阄 鬏
jing2	井
biao2	表
qin4	沁 揿 吣
gu4	故 顾 固 估 雇 锢 梏 牿 崮 痼 鲴 堌
shang1	商 伤 汤 殇 觞 熵 墒
ru3	辱 乳 汝
huo1	豁 劐 攉 锪 耠
fen5	分
gou3	狗 苟 岣 枸 笱
liu2	留 流 刘 瘤 榴 浏 硫 琉 遛 馏 镏 旒 骝 鎏 柳 鏐 镠 飗 溜
ren4	任 认 韧 刃 纫 饪 仞 葚 妊 轫 衽 恁 赁
fa3	法 砝
tu2	图 途 徒 屠 涂 荼 菟 酴 凃 吐 図 土
cong1	从 匆 聪 葱 囱 苁 骢 璁 枞 聡
yan1	烟 燕 咽 殷 焉 淹 阉 腌 嫣 胭 湮 阏 鄢 菸 崦 恹
ｃ5	ｃ
lun1	抡
sha4	沙 啥 厦 煞 霎 嗄 歃 唼
xun2	寻 询 巡 循 旬 驯 荀 峋 洵 恂 郇 浔 鲟 荨 珣 鄩
tao5	桃
tong1	通 恫 嗵 樋
jiong1	扃
hua4	话 华 化 划 画 桦 嬅
hu1	乎 呼 戏 忽 糊 惚 唿 滹 轷 烀
hua2	华 划 滑 哗 豁 猾 骅 铧 蕐
gong3	巩 拱 汞 珙 栱
liang3	两 俩 魉 両
dou4	读 斗 豆 逗 窦 痘 闘 脰
ke5	壳
lou1	搂
dan3	担 胆 掸 赕 疸 瘅 亶
gen2	哏
jie4	界 解 价 介 借 戒 届 藉 诫 芥 疥 蚧 骱 堺
kuan3	款 窾
jie2	结 节 杰 捷 截 洁 劫 竭 睫 桔 拮 孑 诘 桀 碣 偈 颉 讦 婕 羯 鲒 解 結 刼 倢 劼 絜
ju5	矩
yan4	研 验 沿 厌 燕 宴 咽 雁 焰 艳 谚 彦 焱 晏 唁 砚 堰 赝 餍 滟 酽 谳 闫 験 喭 騴
kang4	抗 炕 亢 伉 闶 钪
pang4	胖
yuan2	员 元 原 园 源 圆 缘 援 袁 猿 垣 辕 沅 媛 芫 橼 圜 塬 爰 螈 鼋 远 杬 円
gang1	刚 钢 纲 缸 扛 杠 冈 肛 罡 剛
hu4	护 户 互 糊 虎 沪 祜 扈 戽 笏 岵 怙 瓠 鹱 冱 戸
zhai2	择 宅 翟 窄
zha2	炸 扎 札 喋 轧 闸 铡 油 咋
huang1	荒 慌 肓 谎
san4	散
ei2	诶
nang3	曩
pian1	篇 偏 片 翩 扁
ba3	把 靶 钯 靶
xuan1	宣 喧 轩 萱 暄 谖 揎 儇 煊 瑄
sang1	丧 桑
dong4	动 洞 冻 栋 恫 侗 垌 峒 胨 胴 硐 動
xiao4	笑 校 效 肖 孝 啸 哮 効 咲
sha2	啥
kua3	垮 侉
quan3	犬 绻 畎
ling4	令 另 呤
leng2	楞 棱 塄 冷
dai5	袋 待
piao4	漂 票 嫖 骠
sui3	髓
e2	额 俄 哦 鹅 娥 峨 蛾 讹 莪 锇 扼
na5	呐
bian3	贬 扁 匾 碥 窆 褊
nong1	浓 脓
kai1	开 揩 锎 開
qie4	切 窃 怯 趄 妾 砌 惬 锲 挈 郄 箧 慊
sao4	扫 梢 臊 埽 瘙
gu2	骨 古 鼓 谷
lv5	驴 榈 闾 率
bo1	波 播 拨 剥 玻 饽 菠 钵 趵 鲅 般 蕃 嶓 啵
tou1	偷
bing3	饼 屏 丙 柄 秉 炳 禀 邴 昺 鞆 摒
shun4	顺 舜 瞬
ci1	差 刺 疵 呲
pai3	迫
hao1	蒿 薅 嚆 好
zhou2	轴 妯 碡
shu2	熟 孰 赎 塾 秫 淑
pian4	片 骗
zhuai4	曳 拽 嘬
qia1	掐 伽 葜 袷
tang1	汤 趟 铴 镗 耥 羰 蹚
shen5	神
kang1	康 慷 糠 闶
men1	闷 们
han2	含 寒 汗 韩 涵 函 晗 焓 邯 邗 肣 咁
rang4	让
en1	恩 蒽
tui1	推 忒
sa1	撒 仨 挲
gu5	顾 咕
qiao2	桥 乔 侨 瞧 翘 蕉 憔 樵 峤 谯 荞 鞒 硚
kui2	魁 睽 逵 葵 奎 馗 夔 喹 隗 暌 揆 蝰
niao4	尿 溺
hui1	挥 辉 灰 恢 徽 堕 诙 晖 麾 珲 咴 虺 隳 袆 翚
lao5	姥
biao1	标 彪 勺 镖 膘 骠 镳 杓 飚 飑 飙 瘭 髟 摽 臕
zong3	总 偬 総 捴
zuan3	纂 缵
pao1	抛 泡
chen1	郴 琛 嗔 抻 瞋
cai2	才 财 材 裁 采 纔
wu5	物 务
cao3	草
shui3	水
ken2	恳
ai1	哀 挨 埃 唉 哎 捱 锿 诶 嗳
mu4	墓 暮 幕 募 慕 木 目 睦 牧 穆 沐 牟 钼 苜
bie2	别 蹩 別
wu4	物 务 误 恶 悟 乌 雾 勿 坞 戊 兀 晤 鹜 痦 寤 骛 芴 杌 焐 阢 婺 鋈 钨 毋 嵨 靰
tie3	铁 帖
rang3	嚷 攘 壤 禳
dia3	嗲
dun3	盹 趸
lin2	林 临 秘 邻 琳 淋 霖 麟 鳞 磷 嶙 辚 粼 遴 啉 瞵 璘
pang2	庞 旁 螃 彷 磅 厖 膀 逄
bi4	必 毕 币 秘 避 闭 壁 臂 弊 辟 碧 拂 毙 蔽 庇 璧 敝 泌 陛 弼 篦 婢 愎 痹 铋 裨 濞 髀 庳 毖 滗 蓖 埤 芘 嬖 荜 贲 畀 萆 薜 筚 箅 哔 襞 跸 狴 鷩 閟 觱 苾 皕 坒 诐
ke3	可 渴 坷 轲 岢
shao1	烧 稍 梢 捎 鞘 蛸 筲 艄
ying2	营 迎 赢 盈 蝇 莹 荧 萤 萦 瀛 楹 嬴 茔 滢 潆 荥 蓥 影 盁 営
xin4	信 芯 衅 囟
xiang1	相 香 乡 箱 厢 湘 镶 襄 骧 葙 芗 缃 鄕
zuo5	坐 做
zou1	邹 诹 陬 鄹 驺 鲰
cai1	猜 偲
rui3	蕊
a1	阿 啊 呵 腌 吖 锕 雅
zai1	灾 哉 栽 甾
huang3	晃 恍 谎 幌
shuai3	甩
bang2	榜
lie1	咧
mei4	妹 魅 昧 谜 媚 寐 袂 眛
zu2	足 族 卒 镞 祖 组 崒
bao1	包 胞 炮 剥 褒 苞 孢 煲 龅 襃 枹
zhao1	着 招 朝 嘲 昭 钊 啁 妱
da3	打
zeng1	曾 增 憎 缯 罾 鄫
ku3	苦
dian2	点 典
qu4	去 趣 觑 阒
shu1	书 输 殊 舒 叔 疏 抒 淑 梳 枢 蔬 倏 菽 摅 姝 纾 毹 殳 疋 疎
ni2	霓 倪 泥 尼 梨 呢 铌 坭
ken3	肯 恳 啃 垦 龈
kou4	扣 寇 叩 蔻 筘
ti3	体
nong4	弄
yong5	用
di3	底 抵 诋 邸 砥 坻 柢 氐 骶 的
ren2	人 任 仁 壬
yong2	喁 勇 永 颙
nao4	闹 淖
bing5	病 饼
ran3	染 冉 苒
pie1	撇 瞥 瘪
qiang1	将 枪 抢 腔 呛 锵 跄 羌 戕 戗 镪 蜣 锖
zheng4	政 正 证 挣 郑 症 怔 铮 诤 帧
lan2	兰 蓝 栏 拦 篮 澜 婪 岚 斓 阑 褴 镧 谰
zhuang3	奘
fo2	佛
suo1	缩 莎 梭 嗦 唆 挲 娑 睃 桫 嗍 蓑 羧
min3	敏 悯 闽 泯 皿 抿 闵 愍 黾 鳘 渑 湣 僶
pu1	扑 铺 仆 噗
shang3	上 赏 晌 垧
tai3	呔
lue3	掠
jun1	军 均 君 钧 筠 龟 菌 皲 麇 莙
an1	安 谙 鞍 氨 庵 桉 鹌 胺
le1	肋
lie3	裂 咧
qia4	恰 洽 髂
zuo2	作 昨 琢 笮 左
kao4	靠 铐 犒
sang3	嗓 搡 磉 颡
la3	拉 喇
na3	哪 雫
ha4	哈
wen1	温 瘟
kuan1	宽 髋 寛
pou1	剖
pi2	皮 琵 毗 啤 脾 疲 枇 铍 貔 裨 芘 毘 鼙 埤 郫
hai3	海 胲 醢
luo4	落 络 洛 骆 咯 摞 烙 珞 泺 漯 荦 硌 雒
ti5	笹
da4	大 汏
bai4	败 拜 呗 稗
shi1	师 诗 失 施 尸 湿 狮 嘘 虱 蓍 酾 鲺
jie1	接 结 节 街 阶 皆 揭 楷 嗟 秸 疖 喈 湝
huan3	缓
ang4	盎
wan2	完 玩 顽 丸 纨 芄 烷 碗 婉
nin2	您
guo2	国 帼 掴 馘 虢
zhai1	摘 侧 斋
ban1	般 班 搬 斑 颁 扳 瘢 癍
yun5	晕
tui2	颓 魋
e1	阿 婀 屙
kong3	恐 孔 倥
zhou3	肘 帚
fang2	房 防 妨 坊 肪 鲂
yi2	移 疑 遗 宜 仪 蛇 姨 夷 怡 颐 彝 咦 贻 迤 痍 胰 沂 饴 圯 荑 诒 眙 嶷 一 已 以 谊 簃
zhi1	之 只 知 指 支 织 氏 枝 汁 掷 芝 吱 肢 脂 蜘 栀 卮 胝 祗 稙
shua4	刷
beng3	绷
ben2	本
qu2	渠 瞿 衢 癯 劬 璩 氍 朐 磲 鸲 蕖 蠼 蘧 取 佢 鼩
kuang2	狂 诳
qi1	期 七 欺 栖 漆 妻 凄 柒 年 沏 戚 桼 蹊 嘁 萋
jia2	夹 颊 戛 荚 郏 恝 铗 袷 蛱 浃 鴶 甲
bu2	不 醭 补
tai5	太
jiu5	舅
chai2	柴 豺 侪 船
ting4	梃
nang1	囔
zen3	怎
lv2	缕 旅 侣 驴 榈 闾
zhe2	折 哲 辙 辄 谪 蛰 摺 磔 蜇 褶 喆 馲
hen4	恨
rou2	柔 揉 蹂 糅 鞣 鍒
cu1	粗
du2	读 独 顿 毒 渎 牍 犊 黩 髑 椟
man2	埋 蛮 馒 瞒 蔓 谩 鳗 鞔 满
ou3	藕 呕 偶 耦
lang2	狼 郎 廊 琅 螂 榔 锒 稂 阆
wai3	崴
dou1	都 兜 蔸 篼 督 嘟 唗
huo3	火 伙 夥 钬
mian2	棉 眠 绵
huan4	换 患 幻 唤 宦 焕 痪 涣 浣 奂 擐 豢 漶 逭 鲩
cheng5	诚
xian3	显 险 鲜 洗 跣 猃 藓 铣 燹 蚬 筅 冼 癣 狝 尟 険
chou5	酬
shei2	谁
bie4	别
xiong1	兄 胸 凶 匈 汹 芎
kao1	尻
yin4	印 饮 荫 胤 茚 窨 廕
lian3	脸 敛 琏 蔹 裣
dong3	懂 董 硐
bu5	不 部
o5	哦
gua4	挂 褂 卦 诖
wang1	汪
zeng4	赠 缯 甑 锃
lie4	列 烈 裂 劣 猎 趔 冽 洌 捩 埒 躐 鬣
tuo4	魄 拓 唾 柝 箨
guo1	过 锅 郭 涡 聒 蝈 崞 埚 呙 墎
zhe4	这 浙 蔗 鹧 柘 這 淛
gen1	根 跟
bin1	宾 滨 彬 斌 缤 濒 槟 傧 玢 豳 镔 邠
xin1	心 新 欣 辛 薪 馨 鑫 芯 昕 忻 歆 锌 炘 嬜 莘
fan5	烦
hong1	轰 哄 烘 薨 訇
weng4	瓮 蕹
yun4	运 均 韵 晕 孕 蕴 酝 愠 熨 郓 韫 恽 惲
chuan2	传 船 遄 椽 舡
shi3	使 始 史 驶 屎 矢 豕
die2	叠 迭 碟 谍 蝶 喋 佚 牒 耋 蹀 堞 瓞 揲 垤 鲽
mi4	密 秘 觅 蜜 谧 泌 汨 宓 幂 嘧 祕 糸
sang4	丧
kuang1	框 筐 匡 哐 诓 劻
pang3	耪
mie4	灭 蔑 篾 蠛
qie3	且
piao2	漂 瓢 朴 嫖
bi2	鼻 荸 匕 比
ye4	业 夜 叶 页 液 咽 哗 曳 拽 烨 掖 腋 谒 邺 靥 晔 堨
you5	友
chuai3	揣
tian3	腆 舔 忝 殄 琠
qiu1	秋 邱 丘 龟 蚯 鳅 楸 湫 萩 囚
chun1	春 椿 蝽
di1	提 低 滴 堤 嘀 氐 镝 羝 的 鍉 磾
zong4	纵 粽 综
jiao3	角 脚 搅 缴 绞 饺 矫 佼 狡 剿 侥 皎 挢 徼 湫 敫 铰 鲛 形
ming3	酩
qun1	逡
mian3	免 缅 勉 腼 冕 娩 渑 湎 沔 眄 黾
pao2	咆 袍 刨 庖 龅 匏 炮
zhuai3	拽
dai4	大 代 带 待 戴 袋 贷 逮 殆 黛 怠 玳 岱 迨 骀 绐 埭 甙 帶 襶
chai3	茝
sou1	搜 艘 馊 嗖 溲 飕 锼 螋 捜 鄋 騪
zhong4	中 种 重 众 仲
gang4	钢 杠 戆 筻
sheng1	生 声 胜 升 牲 甥 笙 昇
si5	司 思
kuo4	括 适 阔 扩 廓 栝 蛞
men2	门 扪 钔
dang4	当 荡 档 挡 宕 菪 凼 砀 垱
ding3	顶 鼎 酊
zao2	凿 早
hei1	黑 嘿 嗨 黒
rong5	溶
gang3	港 岗
qin1	亲 钦 侵 衾 親 骎
cuan1	蹿 撺 汆 镩
zhe3	者 褶 锗 赭 啫
fou3	否 缶
pi3	匹 痞 癖 否 嚭 疋
wan5	玩
lou5	喽
wa3	瓦 佤
qiong2	穷 琼 穹 茕 邛 蛩 筇 跫 銎
lai4	赖 睐 癞 籁 赉 濑 瀬
zhua1	抓 挝 髽
zei2	贼
zuo1	作 嘬
min2	民 珉 岷 缗 玟 苠 旻 旼
si3	死
nie4	聂 孽 啮 镊 镍 涅 蘖 蹑
wan3	晚 碗 挽 婉 惋 宛 莞 娩 畹 皖 绾 琬 脘 菀 浣
di5	弟
zheng1	正 争 征 丁 挣 症 睁 徵 蒸 怔 筝 铮 峥 狰 钲 鲭 诤
wen3	稳 吻 紊 刎
duo3	朵 躲 垛 哚 缍 嚲
ning3	拧
wo1	窝 涡 蜗 喔 倭 挝 莴
bie3	瘪
xi3	喜 洗 禧 徙 玺 屣 葸 蓰 铣 枲 囍
sao1	骚 搔 臊 缲 缫 鳋 艘
zhi3	只 指 纸 止 址 旨 徵 趾 咫 芷 枳 祉 轵 黹 酯 至 紙 凪
jia1	家 加 佳 夹 嘉 茄 挟 枷 珈 迦 伽 浃 痂 笳 葭 镓 袈 跏
qia5	恰
ta1	他 她 它 踏 塌 遢 溻 铊 趿
zhuan2	转
chen4	称 趁 衬 秤 谶 榇 龀
peng4	碰
fei1	非 飞 啡 菲 扉 霏 妃 绯 蜚 鲱
jue4	倔
da2	打 达 答 瘩 沓 鞑 怛 笪 靼 妲 哒 炟 鎉
pai4	湃 派
zhuai1	拽
deng1	登 灯 蹬 噔 簦
dai1	待 呆 呔
shao4	少 绍 召 稍 哨 邵 捎 潲 劭 卲
ting1	听 厅 汀 烃 町 桯 聴
jiong3	窘 炯 迥 炅 囧 颎 冏
man1	颟 嫚
hang4	行 巷 沆
pei1	呸 胚 醅
mu3	拇 牡 亩 姆 母 姥
sheng3	省 眚
he1	喝 呵 诃 嗬
miao3	秒 渺 藐 缈 淼 杪 邈 眇
wen4	问 纹 汶 璺 紊 搵
zhuan4	传 转 赚 撰 沌 篆 啭 馔
da5	塔 疸 瘩 跶
fan3	反 返 仮
ke4	克 客 刻 课 恪 嗑 溘 骒 缂 氪 锞 蚵 科 可
yo5	哟
xing1	兴 星 腥 惺 猩
cen1	参
men5	们 們
zhuo2	着 著 琢 缴 灼 酌 浊 濯 茁 啄 斫 镯 诼 禚 擢 浞 卓 斱
fei3	菲 匪 诽 斐 蜚 翡 悱 篚 榧
cheng1	称 撑 秤 瞠 噌 铛 柽 蛏 偁
ruan3	软 阮 朊
yue1	约 曰 矱
ya2	牙 涯 崖 芽 衙 睚 伢 岈 琊 蚜 雅 厓
chi1	吃 痴 哧 嗤 蚩 笞 鸱 媸 螭 眵 魑 摛 絺
leng4	愣
you3	有 友 黝 酉 莠 牖 铕 袍
weng3	蓊
jiong2	炯
chuang2	床 幢
za3	咋
dan1	单 担 丹 耽 眈 殚 箪 儋 瘅 聃 郸
huai2	怀 徊 淮 槐 踝
peng3	捧
o2	哦
tuan4	彖
xin2	寻 镡
rou4	肉 月 宍
cheng4	称 秤
tun2	屯 饨 臀 囤 豚 炖 鲀
yao1	要 约 邀 腰 夭 妖 吆 幺
yi5	易 议 一 意 义
fang3	访 仿 纺 彷 舫 紡 昉
mu2	亩 母 模
wei4	为 位 未 味 卫 谓 遗 慰 魏 蔚 畏 胃 喂 尉 渭 猬 軎
ling5	龄
ou1	欧 鸥 殴 瓯 呕 歐 区
jin2	紧
shang5	裳 上
bei3	北
fei2	肥 腓 淝 身
zu1	租 菹
pin3	品
huan2	还 环 寰 鬟 桓 圜 洹 郇 缳 锾 萑 镮 澴 鹮 嬛
tiao2	条 调 迢 鲦 苕 髫 龆 蜩 笤
pu3	普 谱 埔 朴 圃 浦 溥 蹼
zhuan3	转 転
bao2	薄 雹 保
biao3	表 裱 婊 檦
hou5	候 侯
qiao4	翘 俏 窍 壳 峭 撬 鞘 诮 谯
si4	四 似 食 寺 肆 伺 饲 嗣 巳 祀 驷 泗 俟 汜 兕 姒 耜 笥 赐 涘 禩
zhai3	窄
jia3	假 角 脚 甲 搅 贾 缴 绞 饺 矫 佼 狡 剿 侥 皎 胛 铰 挢 岬 徼 湫 敫 钾 嘏 瘕 椵
rui2	蕤
nan3	赧 腩
yu3	与 语 雨 予 宇 羽 禹 圄 屿 龉 伛 圉 庾 瘐 窳 俣 禺 瑀 楀 鄅
mu5	目
ma2	吗 麻 蟆 马 玛 嘛
hong3	哄
zan1	簪 糌
meng3	蒙 猛 勐 懵 蠓 蜢 锰 艋
niang5	娘
mao3	卯 铆 峁 泖 昴
su5	诉
xi4	系 细 戏 隙 饩 阋 禊 舄 汐 潟 矽 郤
te4	特 忑 忒 慝 铽
qia3	卡 夹
kua4	跨 挎 胯
sheng4	胜 圣 盛 乘 剩 嵊 晟
chu4	处 触 畜 矗 怵 搐 绌 黜 亍 憷 柷
ta3	塔 鳎 獭
pan4	盼 畔 判 叛 泮 袢
mao2	毛 猫 矛 茅 髦 锚 牦 旄 蝥 蟊 茆
zhuan1	专 砖 颛
bang1	帮 邦 浜 梆
za1	扎 咂 匝 拶 帀
wai4	外
xie3	写 血
shun3	吮
lao4	落 络 唠 烙 酪 涝 耢
sao3	扫 嫂
kuang4	况 矿 框 旷 眶 邝 圹 纩 贶 況
tong4	同 通 痛 恸
ge2	革 格 隔 葛 阁 胳 搁 蛤 嗝 骼 颌 搿 膈 镉 塥 鬲 噶 閤
fen4	分 份 奋 愤 粪 忿 偾 瀵 鲼
ga3	嘎 尕
ne5	呢 吶
nv2	女
diao5	掉
kan1	看 刊 堪 勘 龛 戡
hui4	会 汇 惠 慧 溃 绘 讳 贿 晦 秽 诲 彗 烩 荟 卉 喙 恚 浍 哕 缋 桧 蕙 蟪 恵 翙 芔
reng2	仍 礽
ha3	哈
niao2	袅
lv3	旅 履 屡 侣 缕 吕 捋 铝 偻 褛 膂 稆
qing3	请 顷 謦 苘
xing4	性 兴 姓 幸 杏 悻 荇 涬
leng3	冷
hen2	痕 很
liao3	了 潦 燎 蓼 钌
cu4	促 簇 醋 卒 猝 蹴 蹙 蔟 酢
fa2	罚 乏 伐 阀 筏 垡 砝
man3	满 螨 満
liang2	量 良 梁 凉 粮 粱 踉 莨 椋 墚 两 惊
na2	拿 哪
dao4	到 道 倒 悼 盗 稻 焘 纛
shao3	少
zhai4	债 祭 寨 砦 瘵
zha1	查 扎 咋 渣 喳 揸 楂 哳 吒 齄 柤 咤
bang4	棒 膀 傍 磅 谤 镑 蚌 蒡
gui4	贵 桂 跪 柜 刽 炔 刿 桧 炅 鳜 匮
neng2	能
yu5	育 裕 澚
gu1	姑 骨 孤 估 辜 咕 呱 箍 沽 菇 轱 鸪 毂 菰 蛄 酤 觚
can1	参 餐 骖 食
pi1	坯 砒 霹 批 披 劈 丕 邳 铍 噼 纰
bu1	逋 晡 钸
e5	呃
ju3	举 柜 矩 咀 沮 踽 龃 榉 莒 枸 榘
diao1	雕 刁 凋 叼 貂 碉 鲷 奝 鵰
hou2	侯 喉 猴 瘊 篌 糇 骺
tu1	突 秃 凸
tei1	忒
shen1	身 深 参 申 伸 绅 呻 莘 娠 诜 砷 糁 珅 燊
chuai1	揣 搋
zhang1	张 章 彰 璋 蟑 樟 漳 嫜 鄣 獐
sui4	岁 碎 遂 祟 隧 邃 穗 燧 谇 穂 睟 歳
pei2	培 裴 赔 陪
xiu3	宿 朽
chan2	单 缠 禅 蝉 馋 潺 蟾 婵 谗 廛 孱 镡 澶 躔 产 瀍
ting2	停 庭 亭 婷 廷 霆 蜓 葶 莛
shan4	单 善 扇 禅 擅 膳 讪 汕 赡 缮 嬗 掸 骟 剡 苫 鄯 钐 疝 蟮 鳝 掞 墡
lun4	论
cui3	璀 漼
yu1	於 吁 迂 淤 纡 瘀 込
chuo4	绰 啜 辍 龊
tan2	谈 弹 坛 谭 潭 覃 痰 澹 檀 昙 锬 镡 郯
zhe5	着 著
tian1	天 添 婖
jing4	经 境 竟 静 敬 镜 劲 竞 净 径 靖 痉 迳 胫 弪 婧 獍 靓
tai4	太 态 泰 汰 酞 肽 钛
song4	送 宋 诵 颂 讼
tang3	躺 倘 淌 傥 帑 镋
keng1	坑 吭 铿 阬
gan2	赶 敢
nue4	虐 疟
beng1	崩 绷 嘣 祊
guo5	过
mo4	莫 陌 磨 末 默 沫 漠 寞 没 墨 膜 茉 梅 蓦 脉 瘼 靺 殁 秣 抹
cao1	操 糙
pao4	炮 泡 疱 砲
kui4	愧 溃 馈 匮 喟 聩 篑 蒉 愦
que4	却 确 雀 榷 鹊 阕 阙 悫 卻
mou2	谋 某 牟 眸 缪 侔
shi2	时 十 实 什 识 食 石 拾 蚀 埘 莳 炻 鲥 驶 時 實 寔 祏 実 湜
ya4	亚 压 讶 轧 娅 迓 揠 氩 砑
lao3	老 姥 佬 潦 栳 铑
zhou4	皱 骤 轴 宙 咒 昼 胄 纣 绉 荮 籀 繇 酎 伷
bi5	ｂ
shen4	甚 慎 渗 肾 蜃 葚 胂 椹
mei3	美 每 镁 浼
chuai4	揣 啜 踹 嘬 膪
liao2	聊 疗 辽 僚 寥 撩 撂 缭 寮 燎 嘹 獠 鹩 了 憀 潦
hou3	吼
zhao3	找 爪 沼
liu3	柳 绺 锍 铆
miao4	妙 庙 缪
song3	耸 悚 怂 竦
ne2	哪
zhun3	准 凖
li2	离 丽 黎 璃 漓 狸 梨 篱 犁 厘 罹 藜 骊 蜊 黧 缡 喱 鹂 嫠 蠡 鲡 蓠 理 礼 離 嚟 杝
xiang3	想 响 享 飨 饷 鲞 用
ei4	诶
qian3	浅 遣 谴 缱 肷
ban4	办 半 伴 扮 瓣 拌 绊 柈
peng1	砰 抨 烹 澎 嘭 怦
peng2	澎 彭 蓬 棚 硼 篷 膨 朋 鹏 芃 捧
gou1	句 沟 勾 钩 篝 佝 枸 缑 鞲 构
zui2	嘴
gong1	工 公 共 红 供 功 攻 宫 恭 躬 龚 弓 肱 蚣 觥
luo5	罗
lei2	累 雷 擂 羸 镭 嫘 缧 檑 蕾 罍
pi4	僻 屁 譬 辟 媲 淠
fang1	方 芳 妨 坊 邡 枋 钫
gan3	感 敢 赶 杆 橄 秆 擀 澉 扞
dao2	叨 导
kong4	空 控
ma1	妈 麻 摩 抹 蚂 嬷
chen3	碜 墋
pa4	帕 怕
deng2	等
yi1	一 医 衣 依 椅 伊 漪 咿 揖 噫 猗 壹 铱 欹 黟 祎
yuan3	远 遠
che1	车 砗
tan3	坦 毯 忐 袒 钽
duo4	舵 堕 跺 剁 惰 垛 驮 沲 柁
dang1	当 裆 铛 當 珰
xiao2	淆 崤 小 胶
zang3	驵
zui4	最 罪 醉 蕞
me5	么 麽 点 麼
ci2	词 辞 慈 磁 瓷 兹 茨 雌 祠 茈 鹚 糍
tuan2	团 抟
ping1	乒 娉
niu1	妞
zhong1	中 终 钟 忠 衷 锺 盅 忪 螽 舯 柊
bei4	被 备 背 辈 倍 贝 蓓 惫 悖 狈 焙 邶 钡 孛 碚 褙 鐾 鞴 琲
qie1	切
hao2	号 毫 豪 嚎 壕 貉 嗥 濠 蚝 好
lia3	俩
deng3	等 戥
tui4	退 褪 蜕 煺
cao2	曹 槽 嘈 漕 螬 艚 草
hun2	混 魂 浑 馄 珲
qi4	弃 气 器 汽 戚 泣 砌 契 缉 氣 気 碶 憩 迄 葺 炁 碛
ao2	熬 敖 嚣 嗷 鏖 鳌 翱 獒 聱 螯 廒 遨 璈
nu3	努 弩
meng4	梦 孟
pen1	喷
kai3	慨 凯 铠 楷 恺 蒈 剀 垲 锴 闿
kai4	忾
guang3	广 犷
tang2	堂 唐 糖 膛 塘 棠 搪 溏 螳 瑭 樘 镗 螗 饧 醣
cu2	徂 殂
hui2	回 徊 蛔 茴 洄 重 廻
zhan4	战 站 占 颤 绽 湛 蘸 栈 同 戦
ling3	领 令 岭
zheng2	整
chui1	吹 炊
ku1	哭 枯 窟 骷 刳 堀 轱
di4	地 第 帝 弟 递 蒂 缔 谛 睇 棣 娣 碲 绨 的 俤 遰 逓
nian2	年 粘 黏 拈 鲶 鲇
hong2	红 洪 鸿 宏 虹 弘 泓 闳 蕻 黉 荭 触 鋐 紘 纮 竑
chuo1	戳 踔
huai5	划
tou5	头
sou3	擞 叟 薮 嗾 瞍
jian3	简 减 检 剪 捡 拣 俭 碱 茧 柬 蹇 謇 硷 睑 锏 枧 戬 谫 囝 裥 笕 翦 趼 瘦 詃 暕
du5	度 督
fu2	夫 服 福 佛 幅 伏 符 浮 扶 弗 拂 袱 俘 芙 孚 匐 辐 涪 氟 桴 蜉 苻 茯 莩 菔 幞 怫 艴 郛 绂 绋 凫 祓 砩 黻 罘 稃 蚨 芾 蝠 抚 缚 榑 洑 茀 彿 巿
tang4	趟 烫
po2	婆 鄱 陂 皤
diao3	鸟 屌
gen4	亘 艮 茛
pie3	撇 瞥
guan3	管 馆 莞 琯
xie1	些 歇 楔 蝎 猲
wu3	五 武 午 舞 伍 侮 捂 妩 忤 鹉 牾 迕 庑 怃 仵
lie5	咧
ya5	呀
ba1	八 吧 巴 叭 芭 扒 疤 笆 粑 岜 捌 豝
hai4	害 亥 骇 氦
zan4	赞 暂 瓒 錾 讃 酇
gan1	干 甘 肝 杆 尴 乾 竿 坩 苷 柑 泔 矸 疳 酐
de4	嘚
m2	呒
tan4	探 叹 炭 碳
chui2	垂 锤 捶 陲 椎 槌 棰
kun1	昆 坤 鲲 锟 醌 琨 髡 崐 焜
zong2	总
ca1	擦 拆 嚓
po4	破 魄 迫 粕 朴 珀
tun3	氽
xiu4	秀 袖 宿 臭 绣 锈 嗅 岫 溴 琇
huo2	和 活 火
chai4	虿 瘥
zhu2	术 逐 筑 竹 烛 躅 竺 舳 瘃 主
yin3	引 隐 饮 瘾 殷 尹 蚓 吲 飮 淫
qian4	欠 歉 纤 嵌 倩 堑 茜 芡 慊 椠 蒨
qiang3	强 抢 襁 镪 羟
shuang1	双 霜 孀 泷
zhan3	展 斩 辗 盏 崭 搌 嶃
she2	折 舌 蛇 佘
cuo4	错 措 挫 厝 锉
juan4	圈 卷 俊 倦 眷 隽 绢 狷 桊 鄄 劵 巻
tou4	透
nian3	碾 撵 捻 辗 辇
piao5	飘
xing3	省 醒 擤
hai5	害
jie3	解 姐
fan2	凡 烦 繁 泛 樊 蕃 燔 矾 蘩 钒 蹯 帆 璠
tao4	套
ceng1	噌
lei4	类 泪 累 擂 肋 酹 涙
heng2	横 衡 恒 蘅 珩 桁 行
ran2	然 燃 髯 蚺 染
yao5	药
zhi2	直 指 职 值 执 植 殖 侄 踯 摭 絷 跖 埴 只 纸 质 鉄
e3	恶
shuo1	说 說
gai4	概 盖 丐 钙 芥 溉 戤 匄 槩
guan1	关 观 官 冠 棺 矜 莞 倌 纶 鳏 関 観
hen3	很 狠
mao4	冒 贸 帽 貌 茂 耄 瑁 懋 袤 瞀 貿 楙 鄮
cou4	凑 楱 辏 腠
nan5	难
yong1	拥 庸 佣 雍 臃 邕 镛 墉 慵 痈 壅 鳙 饔
chi4	赤 斥 翅 啻 炽 敕 叱 饬 傺 彳 瘛 眙 鶒
dui4	对 队 兑 敦 碓 憝 怼 镦 對
yu4	与 语 育 遇 狱 雨 欲 预 玉 愈 谷 域 誉 吁 蔚 寓 豫 粥 郁 喻 裕 浴 御 驭 尉 谕 毓 妪 峪 芋 昱 煜 熨 燠 菀 蓣 饫 阈 鬻 聿 钰 鹆 鹬 蜮 彧 萸 淯 薁 悆
dai3	逮 歹 傣
ji1	其 几 期 机 基 击 奇 激 积 鸡 迹 绩 饥 缉 圾 姬 矶 肌 讥 叽 稽 畸 跻 羁 嵇 唧 畿 齑 箕 屐 剞 玑 赍 犄 墼 芨 丌 咭 笄 乩 績 襀 撃 勣 禨
huai4	坏 孬
guang4	逛 桄
heng1	哼 亨
ruo5	弱
mo1	摸
ang1	肮
jiang1	将 江 疆 姜 浆 僵 缰 茳 礓 豇 殭
fu3	府 父 腐 抚 辅 甫 俯 斧 脯 釜 腑 拊 滏 黼 符 莆 伏 俛 頫
sun1	孙 荪 狲 飧
shai1	筛 酾
qing1	青 清 轻 倾 卿 氢 蜻 圊 鲭 靑
xuan4	旋 券 炫 渲 绚 眩 铉 泫 碹 楦 镟
liang5	量 亮 粮 粱
hu3	虎 浒 唬 琥
sa3	洒 撒
shu3	数 属 署 鼠 薯 暑 蜀 黍 曙 糬
suo5	嗦
chi2	持 迟 池 驰 匙 弛 踟 墀 茌 篪 坻 援 茬
jiang4	将 强 降 酱 浆 虹 匠 犟 绛 洚 糨 彊
diu1	丢 铥 丟
er5	儿
ya3	雅 瞧 匹 痖 疋 哑
qing4	亲 庆 罄 磬 箐 綮
jie5	家 价 姐 结
yang3	养 仰 痒 氧
ze2	则 责 泽 择 咋 啧 迮 帻 赜 笮 箦 舴 沢
ting3	挺 艇 町 铤 梃 珽
